4 4 4 4 4 4 4 4 4 4 4 4 4 4 4 4 4 4 4 4 4 4 4 4 4 4 4 4 4 4 4 4 4 4 4 4 4 4 4 4 4 4 4 4 4 4 4 4 4 4
4 4 4 4 4 4 4 4 4 4 4 4 4 4 4 4 4 4 4 4 4 4 4 4 4 4 4 4 4 4 4 4 4 4 4 4 4 4 4 4 4 4 4 4 4 4 4 4 4 4
4 4 4 4 4 2 2 0 0 0 0 0 0 0 0 0 0 0 0 0 0 0 0 0 0 0 0 0 0 0 0 0 0 0 0 0 0 0 0 0 0 0 0 0 0 0 6 4 4 4
4 4 4 2 2 2 2 0 0 0 0 0 0 0 0 0 0 0 5 5 5 5 5 5 0 0 0 0 0 0 0 0 0 4 4 4 0 4 4 0 4 4 0 0 0 0 0 0 4 4
4 4 4 2 0 0 0 0 0 0 0 0 0 0 0 0 5 5 5 5 5 5 5 5 5 0 0 0 0 0 0 0 0 0 4 4 4 4 0 4 4 0 0 0 0 0 0 0 4 4
4 4 0 0 0 5 5 5 5 5 5 5 5 5 5 5 5 5 0 0 4 4 0 5 5 5 5 5 5 5 5 5 5 5 5 5 5 5 5 5 5 5 5 5 5 0 0 0 4 4
4 4 0 0 0 5 5 5 5 5 5 5 5 5 5 5 5 0 0 4 4 4 4 0 5 5 5 5 5 5 5 5 5 5 5 5 5 5 5 5 5 5 5 5 5 0 0 0 4 4
4 4 0 0 0 5 5 0 0 0 0 0 0 0 0 0 0 0 4 4 4 4 4 0 0 0 5 5 0 0 0 0 0 0 0 0 0 0 0 0 0 0 0 5 5 0 0 4 4 4
4 4 0 0 0 5 5 0 0 0 4 4 4 4 4 4 4 4 4 4 4 4 4 4 4 6 5 5 0 4 4 4 4 4 4 4 4 4 4 4 4 0 0 5 5 0 0 4 4 4
4 4 0 0 0 5 5 0 0 0 4 4 4 4 4 4 4 4 4 4 4 4 4 4 4 6 5 5 0 4 4 4 4 4 4 4 4 4 4 4 4 0 0 5 5 0 0 4 4 4
4 4 4 0 0 5 5 0 0 0 4 4 4 4 4 0 0 0 0 0 0 0 0 0 0 0 5 5 0 4 4 1 1 1 1 1 1 1 1 4 4 0 0 5 5 0 0 4 4 4
4 4 4 0 0 5 5 0 0 4 4 4 4 4 4 0 0 0 0 0 0 0 0 0 0 0 5 5 0 4 4 1 5 5 5 5 5 5 1 4 4 0 0 5 5 0 0 0 4 4
4 4 4 0 0 5 5 0 0 4 4 4 4 4 4 0 0 0 2 2 2 2 2 0 0 0 5 5 0 4 4 1 5 5 5 5 5 5 1 4 4 0 0 5 5 0 0 0 4 4
4 4 4 0 0 5 5 0 0 4 4 4 4 4 4 0 0 0 2 2 2 2 2 0 0 0 5 5 0 4 4 1 5 3 5 5 5 5 1 4 4 0 0 5 5 0 0 0 4 4
4 4 4 0 0 5 5 0 0 4 4 4 4 4 4 0 0 0 2 2 2 2 2 0 0 0 5 5 0 0 0 0 5 5 5 5 5 5 1 4 4 0 0 5 5 0 0 4 4 4
4 4 4 0 0 5 5 0 0 4 4 4 4 4 4 0 0 0 2 2 2 2 2 0 0 0 5 5 0 4 4 1 5 5 5 5 5 5 1 4 4 0 0 5 5 0 0 0 4 4 
4 4 0 0 0 5 5 0 0 4 4 4 4 4 4 0 0 0 0 0 0 0 0 0 0 0 5 5 0 4 4 1 5 5 5 5 5 5 1 4 4 0 0 5 5 0 0 0 4 4
4 4 0 0 0 5 5 0 0 4 4 4 4 4 4 0 0 0 0 0 0 0 0 0 0 0 5 5 0 4 4 1 1 1 1 1 1 1 1 4 4 0 0 5 5 0 0 4 4 4
4 4 0 0 0 5 5 0 0 0 4 4 4 4 4 4 4 4 4 4 4 4 4 4 4 0 5 5 0 4 4 4 4 4 4 4 4 4 4 4 4 0 0 5 5 0 0 4 4 4
4 4 0 0 0 5 5 0 0 0 4 4 4 4 4 4 4 4 4 4 4 4 4 4 4 0 5 5 0 4 4 4 4 4 4 4 4 4 4 4 4 4 0 5 5 0 0 4 4 4
4 4 0 0 3 5 5 0 0 0 4 4 4 3 3 4 3 6 6 4 4 4 4 4 4 4 5 5 0 4 4 0 0 0 4 4 4 0 0 0 4 4 0 5 5 0 4 4 4 4
4 4 0 0 5 5 5 5 0 0 0 0 0 0 0 0 0 0 0 0 0 0 0 0 0 5 5 5 5 0 0 0 0 0 0 0 0 0 0 0 0 0 5 5 5 5 0 0 4 4
4 4 0 0 5 5 5 5 5 5 5 5 5 5 5 5 5 5 5 5 5 5 5 5 5 5 5 5 5 5 5 5 5 5 5 5 5 5 5 5 5 5 5 5 5 5 0 0 4 4
4 4 0 0 5 5 5 5 5 5 5 5 5 5 5 5 5 5 5 5 5 5 5 5 5 5 5 5 5 5 5 5 5 5 5 5 5 5 5 5 5 5 5 5 5 5 0 0 4 4
4 4 0 0 5 5 5 5 0 0 0 0 0 0 0 0 0 0 0 0 0 0 0 0 0 5 5 5 5 0 0 0 0 0 0 0 0 0 0 0 0 0 5 5 5 5 0 0 4 4
4 4 0 0 0 5 5 0 0 0 0 0 0 0 0 0 0 0 0 0 0 0 0 0 0 0 5 5 0 0 2 2 2 4 0 0 0 0 0 0 0 0 0 5 5 0 0 0 4 4
4 4 0 0 0 5 5 0 0 0 4 4 4 4 4 4 4 4 4 4 4 4 4 4 4 0 5 5 0 2 2 2 4 4 4 4 4 4 4 4 0 0 0 5 5 0 0 4 4 4
4 4 4 0 0 5 5 0 0 0 4 4 4 4 4 4 4 4 4 4 4 4 4 4 4 0 5 5 0 2 2 2 4 4 4 4 4 4 4 4 0 0 0 5 5 0 0 4 4 4
4 4 4 0 0 5 5 0 0 0 4 4 4 4 4 2 2 2 4 4 4 4 4 4 4 0 5 5 0 2 2 4 4 4 4 4 4 4 4 4 0 0 0 5 5 0 0 4 4 4
4 4 4 0 0 5 5 0 0 0 4 4 4 4 4 0 0 0 4 4 4 4 4 4 4 0 5 5 0 2 2 4 4 4 4 4 4 4 4 4 0 0 0 5 5 0 0 4 4 4
4 4 4 0 0 5 5 0 0 0 4 4 4 4 4 4 0 4 4 4 4 4 4 4 4 0 5 5 0 4 4 4 4 4 4 4 4 4 4 4 0 0 0 5 5 0 0 4 4 4
4 4 0 0 0 5 5 0 0 0 4 4 4 4 0 0 0 0 0 4 4 4 4 4 4 0 5 5 0 4 4 4 4 4 4 4 4 4 4 4 0 0 0 5 5 0 0 4 4 4
4 4 0 0 0 5 5 0 0 4 4 4 4 4 4 0 0 0 0 4 4 4 4 4 4 0 5 5 0 4 4 4 4 4 4 4 4 4 4 4 0 0 0 5 5 0 0 4 4 4
4 4 0 0 0 5 5 0 4 4 0 0 0 4 0 0 0 0 4 0 0 4 0 0 0 0 5 5 0 4 4 4 4 4 4 4 4 4 4 4 0 0 0 5 5 0 0 4 4 4
4 4 0 0 0 5 5 0 4 0 0 4 0 0 0 0 0 0 0 4 0 0 0 4 4 4 5 5 0 4 4 4 4 4 4 4 4 4 4 4 0 0 0 5 5 0 0 4 4 4
4 4 0 0 0 5 5 0 0 4 4 4 4 4 4 4 0 0 4 4 4 4 4 4 4 0 5 5 0 4 4 4 4 4 4 4 4 4 4 4 0 0 0 5 5 0 0 4 4 4
4 4 0 0 0 5 5 0 0 0 4 4 4 4 4 4 0 0 0 4 4 4 4 4 4 0 5 5 0 4 4 4 4 4 4 4 4 4 4 4 0 0 0 5 5 0 0 4 4 4
4 4 0 0 0 5 5 0 0 0 4 4 4 4 4 4 4 0 0 4 4 4 4 4 4 0 5 5 0 4 4 4 4 4 4 4 4 4 4 4 0 0 0 5 5 0 0 4 4 4
4 4 4 0 0 5 5 0 0 0 4 4 4 4 4 4 0 0 0 4 4 4 4 4 4 0 5 5 0 4 4 4 4 4 4 4 4 4 4 4 0 0 0 5 5 0 0 4 4 4
4 4 4 0 0 5 5 0 0 4 4 4 0 0 0 0 0 0 4 4 4 4 4 4 4 0 5 5 0 4 4 4 4 4 4 4 4 4 4 4 0 0 0 5 5 0 0 4 4 4
4 4 4 0 0 5 5 0 0 4 4 0 0 0 0 0 0 2 2 2 2 2 2 2 0 0 5 5 0 0 4 4 4 4 4 0 0 0 0 0 0 0 0 5 5 0 0 0 4 4
4 4 4 0 0 5 5 0 0 0 0 0 0 0 2 2 2 2 2 2 2 2 2 2 2 0 5 5 0 0 0 0 0 0 0 0 0 0 0 0 0 0 5 5 5 0 0 0 4 4
4 4 0 0 0 5 5 0 0 0 0 0 0 0 0 0 0 2 4 4 4 4 4 2 0 0 5 5 0 0 0 0 0 0 0 0 0 5 5 5 5 5 5 5 5 0 0 0 4 4
4 4 0 0 0 5 5 5 5 5 5 5 5 5 5 5 5 5 5 4 4 4 4 5 5 5 5 5 5 5 5 5 5 5 5 5 5 5 5 5 5 5 5 5 0 0 0 4 4 4
4 4 0 0 0 5 5 5 5 5 5 5 5 5 5 5 5 5 5 5 4 4 5 5 5 5 5 5 5 5 5 5 5 5 5 5 5 5 5 5 0 0 0 0 0 0 4 4 4 4
4 4 4 4 4 2 2 0 0 0 0 0 0 0 0 0 5 5 5 5 5 5 5 5 5 0 0 0 0 4 4 4 0 0 0 0 0 0 0 4 4 0 0 4 4 4 4 4 4 4
4 4 4 2 2 2 2 2 2 2 2 0 0 0 0 0 0 0 5 5 5 5 5 5 0 0 0 3 4 4 4 4 4 4 4 4 0 4 4 0 4 4 0 0 0 0 2 2 4 4
4 4 4 2 4 4 4 4 4 4 2 2 2 2 0 0 0 0 0 0 0 0 0 0 0 0 0 0 0 0 0 0 0 0 4 4 4 4 0 4 4 0 0 0 0 0 0 2 4 4
4 4 4 4 4 4 4 4 4 4 4 4 4 4 4 4 4 4 4 4 4 4 4 4 4 4 4 4 4 4 4 2 2 2 2 4 4 4 4 4 4 4 4 4 4 0 0 4 4 4
4 4 4 4 4 4 4 4 4 4 4 4 4 4 4 4 4 4 4 4 4 4 4 4 4 4 4 4 4 2 2 2 2 2 2 2 2 4 4 4 4 4 4 4 4 0 0 4 4 4
